
0 0 0 0 0 0 0 0 0 0 0 0 0 0 0 2 0 0 0 0 0 0 0 0 0 0 0 0 0 0 0
0 0 0 0 0 0 0 0 0 0 0 0 0 0 2 2 2 0 0 0 0 0 0 0 0 0 0 0 0 0 0
0 0 0 0 0 0 0 0 0 0 0 0 0 2 2 2 2 2 0 0 0 0 0 0 0 0 0 0 0 0 0
0 0 0 0 0 0 0 0 0 0 0 0 2 2 2 2 2 2 2 0 0 0 0 0 0 0 0 0 0 0 0
0 0 0 0 0 0 0 0 0 0 0 0 2 0 0 0 0 0 2 0 0 0 0 0 0 0 0 0 0 0 0
0 0 0 0 0 0 0 0 0 0 0 0 2 0 0 0 0 0 2 0 0 0 0 0 0 0 0 0 0 0 0
0 0 0 0 0 0 0 0 0 0 0 0 2 0 0 0 0 0 2 0 0 0 0 0 0 0 0 0 0 0 0
0 0 0 0 0 0 0 0 0 0 0 0 2 2 2 2 2 2 2 0 0 0 0 0 0 0 0 0 0 0 0
0 0 0 0 0 0 0 0 0 0 0 0 0 2 2 2 2 2 0 0 0 0 0 0 0 0 0 0 0 0 0
0 0 0 0 0 0 0 0 0 0 0 0 0 0 2 2 2 0 0 0 0 0 0 0 0 0 0 0 0 0 0
0 0 0 0 0 0 0 0 0 0 0 0 0 0 0 2 0 0 0 0 0 0 0 0 0 0 0 0 0 0 0
0 0 0 2 2 2 2 2 0 0 0 0 0 0 2 2 2 0 0 0 0 0 0 2 2 2 2 3 0 0 0
0 0 2 2 0 0 0 2 2 0 0 0 0 2 2 2 2 2 0 0 0 0 2 2 0 0 0 2 2 0 0
0 2 2 2 0 0 0 2 2 2 0 0 2 2 2 2 2 2 2 0 0 2 2 2 0 0 0 2 2 2 0
2 2 2 2 0 0 0 2 2 2 2 2 2 2 2 2 2 2 2 2 2 2 2 2 0 0 0 2 2 2 2
0 2 2 2 0 0 0 2 2 2 0 0 2 2 2 2 2 2 2 0 0 2 2 2 0 0 0 2 2 2 0
0 0 2 2 0 0 0 2 2 0 0 0 0 2 2 2 2 2 0 0 0 0 2 2 0 0 0 2 2 0 0
0 0 0 2 2 2 2 2 0 0 0 0 0 0 2 2 2 0 0 0 0 0 0 2 2 2 2 2 0 0 0
0 0 0 0 0 0 0 0 0 0 0 0 0 0 2 2 2 0 0 0 0 0 0 0 0 0 0 0 0 0 0
0 0 0 2 2 2 2 2 0 0 0 0 0 0 2 2 2 0 0 0 0 0 0 2 2 2 2 2 0 0 0
0 0 2 2 0 0 0 2 2 0 0 0 0 2 2 2 2 2 0 0 0 0 2 2 0 0 0 2 2 0 0
0 2 2 2 0 0 0 2 2 2 0 0 2 2 2 2 2 2 2 0 0 2 2 2 0 0 0 2 2 2 0
2 2 2 2 0 0 0 2 2 2 2 2 2 2 2 2 2 2 2 2 2 2 2 2 0 0 0 2 2 2 2
0 2 2 2 0 0 0 2 2 2 0 0 2 2 2 2 2 2 2 0 0 2 2 2 0 0 0 2 2 2 0
0 0 2 2 0 0 0 2 2 0 0 0 0 2 2 2 2 2 0 0 0 0 2 2 0 0 0 2 2 0 0
0 0 0 2 2 2 2 2 0 0 0 0 0 0 2 2 2 0 0 0 0 0 0 2 2 2 2 2 0 0 0
0 0 0 0 0 0 0 0 0 0 0 0 0 0 2 2 2 0 0 0 0 0 0 0 0 0 0 0 0 0 0
0 0 0 2 2 2 2 2 0 0 0 0 0 0 2 2 2 0 0 0 0 0 0 2 2 2 2 2 0 0 0
0 0 2 2 0 0 0 2 2 0 0 0 0 2 2 2 2 2 0 0 0 0 2 2 0 0 0 2 2 0 0
0 2 2 2 0 0 0 2 2 2 0 0 2 2 2 2 2 2 2 0 0 2 2 2 0 0 0 2 2 2 0
2 2 2 2 0 0 0 2 2 2 2 2 2 2 2 2 2 2 2 2 2 2 2 2 0 0 0 2 2 2 2
0 2 2 2 0 0 0 2 2 2 0 0 2 2 2 2 2 2 2 0 0 2 2 2 0 0 0 2 2 2 0
0 0 2 2 0 0 0 2 2 0 0 0 0 2 2 2 2 2 0 0 0 0 2 2 0 0 0 2 2 0 0
0 0 0 2 2 2 2 2 0 0 0 0 0 0 2 2 2 0 0 0 0 0 0 2 2 2 2 2 0 0 0
0 0 0 0 0 0 0 0 0 0 0 0 0 0 0 2 0 0 0 0 0 0 0 0 0 0 0 0 0 0 0
0 0 0 0 0 0 0 0 0 0 0 0 0 0 2 2 2 0 0 0 0 0 0 0 0 0 0 0 0 0 0
0 0 0 0 0 0 0 0 0 0 0 0 0 2 2 2 2 2 0 0 0 0 0 0 0 0 0 0 0 0 0
0 0 0 0 0 0 0 0 0 0 0 0 2 2 2 2 2 2 2 0 0 0 0 0 0 0 0 0 0 0 0
0 0 0 0 0 0 0 0 0 0 0 0 2 0 0 0 0 0 2 0 0 0 0 0 0 0 0 0 0 0 0
0 0 0 0 0 0 0 0 0 0 0 0 2 0 0 0 0 0 2 0 0 0 0 0 0 0 0 0 0 0 0
0 0 0 0 0 0 0 0 0 0 0 0 2 0 0 0 0 0 2 0 0 0 0 0 0 0 0 0 0 0 0
0 0 0 0 0 0 0 0 0 0 0 0 2 2 2 2 2 2 2 0 0 0 0 0 0 0 0 0 0 0 0
0 0 0 0 0 0 0 0 0 0 0 0 0 2 2 2 2 2 0 0 0 0 0 0 0 0 0 0 0 0 0
0 0 0 0 0 0 0 0 0 0 0 0 0 0 2 2 2 0 0 0 0 0 0 0 0 0 0 0 0 0 0
0 0 0 0 0 0 0 0 0 0 0 0 0 0 0 2 0 0 0 0 0 0 0 0 0 0 0 0 0 0 0


0 0 0 2 2 2 2 2 0 0 0
0 0 2 2 0 0 0 2 2 0 0
0 2 2 2 0 0 0 2 2 2 0
2 2 2 2 0 0 0 2 2 2 2
0 2 2 2 0 0 0 2 2 2 0
0 0 2 2 0 0 0 2 2 0 0
0 0 0 2 2 2 2 2 0 0 0


total # steps taken after each fragment
[21, 56, 92, 134, 170, 212, 247, 282]

total # rollouts executed after each fragment
[16000, 16000, 32000, 32000, 32000, 32000, 32000, 32000]

total time taken to explore each fragment
[7.9618752002716064, 7.963011026382446, 15.95165205001831, 15.95278000831604, 15.953890085220337, 15.954953908920288, 15.955806970596313, 15.95673418045044]

% of rooms explored after each fragment
[0.32084309133489464, 0.40046838407494145, 0.48009367681498827, 0.6206088992974239, 0.7002341920374707, 0.8407494145199064, 0.9203747072599532, 1.0]

