0 0 0 0 0 0 0 0 0 0 0 0 0 0 0 2 0 0 0 0 0 0 0 0 0 0 0 0 0 0 0
0 0 0 0 0 0 0 0 0 0 0 0 0 0 2 2 2 0 0 0 0 0 0 0 0 0 0 0 0 0 0
0 0 0 0 0 0 0 0 0 0 0 0 0 2 2 2 2 2 0 0 0 0 0 0 0 0 0 0 0 0 0
0 0 0 0 0 0 0 0 0 0 0 0 2 2 2 2 2 2 2 0 0 0 0 0 0 0 0 0 0 0 0
0 0 0 0 0 0 0 0 0 0 0 0 2 0 0 0 0 0 2 0 0 0 0 0 0 0 0 0 0 0 0
0 0 0 0 0 0 0 0 0 0 0 0 2 0 0 0 0 0 2 0 0 0 0 0 0 0 0 0 0 0 0
0 0 0 0 0 0 0 0 0 0 0 0 2 0 0 0 0 0 2 0 0 0 0 0 0 0 0 0 0 0 0
0 0 0 0 0 0 0 0 0 0 0 0 2 2 2 2 2 2 2 0 0 0 0 0 0 0 0 0 0 0 0
0 0 0 0 0 0 0 0 0 0 0 0 0 2 2 2 2 2 0 0 0 0 0 0 0 0 0 0 0 0 0
0 0 0 0 0 0 0 0 0 0 0 0 0 0 2 2 2 0 0 0 0 0 0 0 0 0 0 0 0 0 0
0 0 0 0 0 0 0 0 0 0 0 0 0 0 0 2 0 0 0 0 0 0 0 0 0 0 0 0 0 0 0
0 0 0 2 2 2 2 2 0 0 0 0 0 0 2 2 2 0 0 0 0 0 0 2 2 2 2 2 0 0 0
0 0 2 2 0 0 0 2 2 0 0 0 0 2 2 2 2 2 0 0 0 0 2 2 0 0 0 2 2 0 0
0 2 2 2 0 0 0 2 2 2 0 0 2 2 2 2 2 2 2 0 0 2 2 2 0 0 0 2 2 2 0
2 2 2 2 0 0 0 2 2 2 2 2 2 2 2 2 2 2 2 2 2 2 2 2 0 0 0 2 2 2 2
0 2 2 2 0 0 0 2 2 2 0 0 2 2 2 2 2 2 2 0 0 2 2 2 0 0 0 2 2 2 0
0 0 2 2 0 0 0 2 2 0 0 0 0 2 2 2 2 2 0 0 0 0 2 2 0 0 0 2 2 0 0
0 0 0 2 2 2 2 2 0 0 0 0 0 0 2 2 2 0 0 0 0 0 0 2 2 2 2 2 0 0 0
0 0 0 0 0 0 0 0 0 0 0 0 0 0 2 2 2 0 0 0 0 0 0 0 0 0 0 0 0 0 0
0 0 0 2 2 2 2 2 0 0 0 0 0 0 2 2 2 0 0 0 0 0 0 2 2 2 2 2 0 0 0
0 0 2 2 0 0 0 2 2 0 0 0 0 2 2 2 2 2 0 0 0 0 2 2 0 0 0 2 2 0 0
0 2 2 2 0 0 0 2 2 2 0 0 2 2 2 2 2 2 2 0 0 2 2 2 0 0 0 2 2 2 0
2 2 2 2 0 0 0 2 2 2 2 2 2 2 2 2 2 2 2 2 2 2 2 2 0 0 0 2 2 2 2
0 2 2 2 0 0 0 2 2 2 0 0 2 2 2 2 2 2 2 0 0 2 2 2 0 0 0 2 2 2 0
0 0 2 2 0 0 0 2 2 0 0 0 0 2 2 2 2 2 0 0 0 0 2 2 0 0 0 2 2 0 0
0 0 0 2 2 2 2 2 0 0 0 0 0 0 2 2 2 0 0 0 0 0 0 2 2 2 2 2 0 0 0
0 0 0 0 0 0 0 0 0 0 0 0 0 0 2 2 2 0 0 0 0 0 0 0 0 0 0 0 0 0 0
0 0 0 2 2 2 2 2 0 0 0 0 0 0 2 2 2 0 0 0 0 0 0 2 2 2 2 2 0 0 0
0 0 2 2 0 0 0 2 2 0 0 0 0 2 2 2 2 2 0 0 0 0 2 2 0 0 0 2 2 0 0
0 2 2 2 0 0 0 2 2 2 0 0 2 2 2 2 2 2 2 0 0 2 2 2 0 0 0 2 2 2 0
2 2 2 2 0 0 0 2 2 2 2 2 2 2 2 3 2 2 2 2 2 2 2 2 0 0 0 2 2 2 2
0 2 2 2 0 0 0 2 2 2 0 0 2 2 2 2 2 2 2 0 0 2 2 2 0 0 0 2 2 2 0
0 0 2 2 0 0 0 2 2 0 0 0 0 2 2 2 2 2 0 0 0 0 2 2 0 0 0 2 2 0 0
0 0 0 2 2 2 2 2 0 0 0 0 0 0 2 2 2 0 0 0 0 0 0 2 2 2 2 2 0 0 0
0 0 0 0 0 0 0 0 0 0 0 0 0 0 0 2 0 0 0 0 0 0 0 0 0 0 0 0 0 0 0
0 0 0 0 0 0 0 0 0 0 0 0 0 0 2 2 2 0 0 0 0 0 0 0 0 0 0 0 0 0 0
0 0 0 0 0 0 0 0 0 0 0 0 0 2 2 2 2 2 0 0 0 0 0 0 0 0 0 0 0 0 0
0 0 0 0 0 0 0 0 0 0 0 0 2 2 2 2 2 2 2 0 0 0 0 0 0 0 0 0 0 0 0
0 0 0 0 0 0 0 0 0 0 0 0 2 0 0 0 0 0 2 0 0 0 0 0 0 0 0 0 0 0 0
0 0 0 0 0 0 0 0 0 0 0 0 2 0 0 0 0 0 2 0 0 0 0 0 0 0 0 0 0 0 0
0 0 0 0 0 0 0 0 0 0 0 0 2 0 0 0 0 0 2 0 0 0 0 0 0 0 0 0 0 0 0
0 0 0 0 0 0 0 0 0 0 0 0 2 2 2 2 2 2 2 0 0 0 0 0 0 0 0 0 0 0 0
0 0 0 0 0 0 0 0 0 0 0 0 0 2 2 2 2 2 0 0 0 0 0 0 0 0 0 0 0 0 0
0 0 0 0 0 0 0 0 0 0 0 0 0 0 2 2 2 0 0 0 0 0 0 0 0 0 0 0 0 0 0
0 0 0 0 0 0 0 0 0 0 0 0 0 0 0 2 0 0 0 0 0 0 0 0 0 0 0 0 0 0 0


Exploration result with time limit
time elapsed: 12.962822437286377
percentage of map explored: 0.25526932084309134

Exploration result with generator call limit
total calls to generator: 585227
percentage of map explored: 0.3629976580796253

