0 0 0 0 0 0 0 0 0 0 0 0 0 0 0 0 0 0 0 0 0 0 0 0 0 0 0 0 0 0 0 0 0 0 0 0 0 0 0 0 0 0 0 0 0
0 0 0 0 0 0 0 0 0 0 0 0 0 0 0 0 0 0 0 0 0 0 0 0 0 0 0 0 0 0 0 0 0 0 0 0 0 0 0 0 0 0 0 0 0
0 2 2 2 2 2 2 2 2 2 2 2 2 2 2 2 2 2 2 2 2 2 2 2 2 2 2 2 2 2 2 2 2 2 2 2 2 2 2 2 2 2 0 0 0
0 2 0 0 0 0 0 0 0 0 0 0 0 0 0 0 0 0 0 0 0 0 0 0 0 0 0 0 0 0 0 0 0 0 0 0 0 0 0 0 0 2 0 0 0
0 2 0 2 2 2 2 2 2 2 2 2 2 2 2 2 2 2 2 2 2 2 2 2 2 2 2 0 0 0 0 0 0 0 0 0 0 0 0 0 0 2 0 0 0
0 2 0 2 0 0 0 0 0 0 0 0 0 0 0 0 0 0 0 0 0 0 0 0 0 0 2 0 0 0 0 0 0 0 0 0 0 0 0 0 0 2 0 0 0
0 2 0 2 2 2 2 2 2 2 0 0 2 2 2 2 2 0 0 2 2 2 2 2 0 0 2 2 2 2 2 0 0 2 2 2 2 2 0 0 2 2 2 2 0
0 2 0 2 0 2 0 0 0 2 0 0 2 0 0 0 2 0 0 2 0 0 0 2 0 0 2 0 0 0 2 0 0 2 0 0 0 2 0 0 2 0 0 2 0
0 2 0 2 0 2 0 0 0 2 2 2 2 0 0 0 2 2 2 2 0 0 0 2 2 2 2 0 0 0 2 2 2 2 0 0 0 2 2 2 2 0 2 2 2
0 2 0 2 0 2 0 0 0 2 0 0 2 0 0 0 2 0 0 2 0 0 0 2 0 0 2 0 0 0 2 0 0 2 0 0 0 2 0 0 2 0 0 2 0
0 2 0 2 0 2 2 2 2 2 0 0 2 2 2 2 2 0 0 2 2 2 2 2 0 0 2 2 2 2 2 0 0 2 2 2 2 2 0 0 2 2 2 2 0
0 2 0 2 0 0 0 0 0 0 0 0 0 0 0 0 0 0 0 0 0 0 0 0 0 0 2 0 0 0 0 0 0 0 0 0 0 0 0 0 0 2 0 0 0
0 2 0 2 0 0 0 0 0 0 0 0 0 0 0 0 0 0 0 0 0 0 0 0 0 0 2 0 0 0 0 0 0 0 0 0 0 0 0 0 0 2 0 0 0
0 2 0 2 0 0 0 0 0 0 0 0 0 0 0 0 0 0 0 0 0 0 0 0 0 0 2 0 0 0 0 0 0 0 0 0 0 0 0 0 0 2 0 0 0
0 2 2 2 2 2 2 2 2 2 2 2 2 2 2 2 2 2 2 2 2 2 2 2 2 2 2 2 2 2 2 2 2 2 2 2 2 2 2 2 2 2 0 0 0
0 2 2 2 2 2 2 2 2 2 2 2 2 2 2 2 2 2 2 2 2 2 2 2 2 2 2 2 2 2 2 2 2 2 2 2 2 2 2 2 2 2 0 0 0
0 2 0 2 0 0 0 0 0 0 0 0 0 0 0 0 0 0 0 0 0 0 0 0 0 0 2 0 0 0 0 0 0 0 0 0 0 0 0 0 0 2 0 0 0
0 2 0 2 0 0 0 0 0 0 0 0 0 0 0 0 0 0 0 0 0 0 0 0 0 0 2 0 0 0 0 0 0 0 0 0 0 0 0 0 0 2 0 0 0
0 2 0 2 0 0 0 0 0 0 0 0 0 0 0 0 0 0 0 0 0 0 0 0 0 0 2 0 0 0 0 0 0 0 0 0 0 0 0 0 0 2 0 0 0
0 2 0 2 0 2 2 2 2 2 0 0 2 2 2 2 2 0 0 2 2 2 2 2 0 0 2 2 2 2 2 0 0 2 2 2 2 2 0 0 2 2 2 2 0
0 2 0 2 0 2 0 0 0 2 0 0 2 0 0 0 2 0 0 2 0 0 0 2 0 0 2 0 0 0 2 0 0 2 0 0 0 2 0 0 2 0 0 2 0
0 2 0 2 0 2 0 0 0 2 2 2 2 0 0 0 2 2 2 2 0 0 0 2 2 2 2 0 0 0 2 2 2 2 0 0 0 2 2 2 2 0 2 2 2
0 2 0 2 0 2 0 0 0 3 0 0 2 0 0 0 2 0 0 2 0 0 0 2 0 0 2 0 0 0 2 0 0 2 0 0 0 2 0 0 2 0 0 2 0
0 2 0 2 2 2 2 2 2 2 0 0 2 2 2 2 2 0 0 2 2 2 2 2 0 0 2 2 2 2 2 0 0 2 2 2 2 2 0 0 2 2 2 2 0
0 2 0 2 0 0 0 0 0 0 0 0 0 0 0 0 0 0 0 0 0 0 0 0 0 0 2 0 0 0 0 0 0 0 0 0 0 0 0 0 0 2 0 0 0
0 2 0 2 2 2 2 2 2 2 2 2 2 2 2 2 2 2 2 2 2 2 2 2 2 2 2 0 0 0 0 0 0 0 0 0 0 0 0 0 0 2 0 0 0
0 2 0 0 0 0 0 0 0 0 0 0 0 0 0 0 0 0 0 0 0 0 0 0 0 0 0 0 0 0 0 0 0 0 0 0 0 0 0 0 0 2 0 0 0
0 2 2 2 2 2 2 2 2 2 2 2 2 2 2 2 2 2 2 2 2 2 2 2 2 2 2 2 2 2 2 2 2 2 2 2 2 2 2 2 2 2 0 0 0
0 0 0 0 0 0 0 0 0 0 0 0 0 0 0 0 0 0 0 0 0 0 0 0 0 0 0 0 0 0 0 0 0 0 0 0 0 0 0 0 0 0 0 0 0
0 0 0 0 0 0 0 0 0 0 0 0 0 0 0 0 0 0 0 0 0 0 0 0 0 0 0 0 0 0 0 0 0 0 0 0 0 0 0 0 0 0 0 0 0


Naive percentage explored at time checkpoints
[0.00411522633744856, 0.006172839506172839, 0.00823045267489712, 0.00823045267489712, 0.0102880658436214, 0.012345679012345678, 0.012345679012345678, 0.047325102880658436, 0.04938271604938271, 0.04938271604938271, 0.053497942386831275]

Naive percentage explored at rollout checkpoints
[0.00411522633744856, 0.006172839506172839, 0.006172839506172839, 0.006172839506172839, 0.00823045267489712, 0.00823045267489712, 0.00823045267489712, 0.00823045267489712, 0.00823045267489712, 0.0102880658436214, 0.018518518518518517]

