0 0 0 0 0 0 0 0 0 0 0 0 0 0 0 0 0 0 0 0 0 0 0 0 0 0 0 0 0 0 0 0 0 0 0 0 0 0 0 0 0 0 0 0 0
0 2 2 2 2 2 2 0 0 0 2 2 2 2 2 2 0 0 0 2 2 2 2 2 2 0 0 0 2 2 2 2 2 2 0 0 0 2 2 2 2 2 2 0 0
0 2 0 0 0 0 2 2 0 0 2 0 0 0 0 2 2 0 0 2 0 0 0 0 2 2 0 0 2 0 0 0 0 2 2 0 0 2 0 0 0 0 2 2 0
0 2 0 2 2 0 2 2 2 0 2 0 2 2 0 2 2 2 0 2 0 2 2 0 2 2 2 0 2 0 2 2 0 2 2 2 0 2 0 2 2 0 2 2 2
0 2 2 2 2 0 2 2 2 2 2 2 2 2 0 2 2 2 2 2 2 2 2 0 2 2 2 2 2 2 2 2 0 2 2 2 2 2 2 2 2 0 2 2 2
0 2 0 2 2 0 2 2 2 0 2 0 2 2 0 2 2 2 0 2 0 2 2 0 2 2 2 0 2 0 2 2 0 2 2 2 0 2 0 2 2 0 2 2 2
0 2 0 0 0 0 2 2 0 0 2 0 0 0 0 2 2 0 0 2 0 0 0 0 2 2 0 0 2 0 0 0 0 2 2 0 0 2 0 0 0 0 2 2 0
0 2 2 2 2 2 2 0 0 0 2 2 2 2 2 2 0 0 0 2 2 2 2 2 2 0 0 0 2 2 2 2 2 2 0 0 0 2 2 2 2 2 2 0 0
0 2 0 0 0 0 0 0 0 0 2 0 0 0 0 0 0 0 0 2 0 0 0 0 0 0 0 0 2 0 0 0 0 0 0 0 0 2 0 0 0 0 0 0 0
0 2 0 0 0 0 0 0 0 0 2 0 0 0 0 0 0 0 0 2 0 0 0 0 0 0 0 0 2 0 0 0 0 0 0 0 0 2 0 0 0 0 0 0 0
0 2 0 0 0 0 0 0 0 0 2 0 0 0 0 0 0 0 0 2 0 0 0 0 0 0 0 0 2 0 0 0 0 0 0 0 0 2 0 0 0 0 0 0 0
0 2 0 0 0 0 0 0 0 0 2 0 0 0 0 0 0 0 0 2 0 0 0 0 0 0 0 0 2 0 0 0 0 0 0 0 0 2 0 0 0 0 0 0 0
0 2 0 0 0 0 0 0 0 0 2 0 0 0 0 0 0 0 0 2 0 0 0 0 0 0 0 0 2 0 0 0 0 0 0 0 0 2 0 0 0 0 0 0 0
0 2 0 0 0 0 0 0 0 0 2 0 0 0 0 0 0 0 0 2 0 0 0 0 0 0 0 0 2 0 0 0 0 0 0 0 0 2 0 0 0 0 0 0 0
0 2 0 0 0 0 0 0 0 0 2 0 0 0 0 0 0 0 0 2 0 0 0 0 0 0 0 0 2 0 0 0 0 0 0 0 0 2 0 0 0 0 0 0 0
0 2 0 0 0 0 0 0 0 0 2 0 0 0 0 0 0 0 0 2 0 0 0 0 0 0 0 0 2 0 0 0 0 0 0 0 0 2 0 0 0 0 0 0 0
0 2 0 0 0 0 0 0 0 0 2 0 0 0 0 0 0 0 0 2 0 0 0 0 0 0 0 0 2 0 0 0 0 0 0 0 0 2 0 0 0 0 0 0 0
0 2 0 0 0 0 0 0 0 0 2 0 0 0 0 0 0 0 0 2 0 0 0 0 0 0 0 0 2 0 0 0 0 0 0 0 0 2 0 0 0 0 0 0 0
0 2 0 0 0 0 0 0 0 0 2 0 0 0 0 0 0 0 0 2 0 0 0 0 0 0 0 0 2 0 0 0 0 0 0 0 0 2 0 0 0 0 0 0 0
0 2 0 0 0 0 0 0 0 0 2 0 0 0 0 0 0 0 0 2 0 0 0 0 0 0 0 0 2 0 0 0 0 0 0 0 0 2 0 0 0 0 0 0 0
0 2 0 0 0 0 0 0 0 0 2 0 0 0 0 0 0 0 0 2 0 0 0 0 0 0 0 0 2 0 0 0 0 0 0 0 0 2 0 0 0 0 0 0 0
0 2 0 0 0 0 0 0 0 0 2 0 0 0 0 0 0 0 0 2 0 0 0 0 0 0 0 0 2 0 0 0 0 0 0 0 0 2 0 0 0 0 0 0 0
0 2 2 2 2 2 2 0 0 0 2 2 2 2 2 2 0 0 0 2 2 2 2 2 2 0 0 0 2 2 2 2 2 2 0 0 0 2 2 2 2 2 2 0 0
0 2 0 0 0 0 2 2 0 0 2 0 0 0 0 2 2 0 0 2 0 0 0 0 2 2 0 0 2 0 0 0 0 2 2 0 0 2 0 0 0 0 2 2 0
0 2 0 2 2 0 2 2 2 0 2 0 2 2 0 2 2 2 0 2 0 2 2 0 2 2 2 0 2 0 2 2 0 2 2 2 0 2 0 2 2 0 2 2 2
0 2 2 2 2 0 2 3 2 2 2 2 2 2 0 2 2 2 2 2 2 2 2 0 2 2 2 2 2 2 2 2 0 2 2 2 2 2 2 2 2 0 2 2 2
0 2 0 2 2 0 2 2 2 0 2 0 2 2 0 2 2 2 0 2 0 2 2 0 2 2 2 0 2 0 2 2 0 2 2 2 0 2 0 2 2 0 2 2 2
0 2 0 0 0 0 2 2 0 0 2 0 0 0 0 2 2 0 0 2 0 0 0 0 2 2 0 0 2 0 0 0 0 2 2 0 0 2 0 0 0 0 2 2 0
0 2 2 2 2 2 2 0 0 0 2 2 2 2 2 2 0 0 0 2 2 2 2 2 2 0 0 0 2 2 2 2 2 2 0 0 0 2 2 2 2 2 2 0 0
0 0 0 0 0 0 0 0 0 0 0 0 0 0 0 0 0 0 0 0 0 0 0 0 0 0 0 0 0 0 0 0 0 0 0 0 0 0 0 0 0 0 0 0 0


Naive percentage explored at time checkpoints
[0.004464285714285714, 0.011160714285714286, 0.029017857142857144, 0.03125, 0.10491071428571429, 0.15625, 0.18080357142857142, 0.203125, 0.22321428571428573, 0.22321428571428573]

Naive percentage explored at rollout checkpoints
[0.004464285714285714, 0.008928571428571428, 0.022321428571428572, 0.022321428571428572, 0.046875, 0.046875, 0.046875, 0.046875, 0.05357142857142857, 0.05357142857142857]

