0 0 0 0 0 0 0 0 0 0 0 0 0 0 0 0 0 0 0 0 0 0 0 0 0 0 0 0 0 0 0 0 0 0 0 0 0 0 0 0 0 0 0 0 0
0 0 0 0 0 0 2 2 2 2 2 0 0 0 0 0 0 0 0 0 2 2 2 2 2 0 0 0 0 0 0 0 0 0 2 2 2 2 2 0 0 0 0 0 0
0 0 0 0 0 2 2 0 2 0 2 2 0 0 0 0 0 0 0 2 2 0 2 0 2 2 0 0 0 0 0 0 0 2 2 0 2 0 2 2 0 0 0 0 0
0 0 0 0 2 2 0 0 2 0 0 2 2 0 0 0 0 0 2 2 0 0 2 0 0 2 2 0 0 0 0 0 2 2 0 0 2 0 0 2 2 0 0 0 0
0 0 0 2 2 0 0 2 2 2 0 0 2 2 0 0 0 2 2 0 0 2 2 2 0 0 2 2 0 0 0 2 2 0 0 2 2 2 0 0 2 2 0 0 0
0 0 2 2 0 0 2 2 2 2 2 0 0 2 2 0 2 2 0 0 2 2 2 2 2 0 0 2 2 0 2 2 0 0 2 2 2 2 2 0 0 2 2 0 0
0 2 2 0 0 2 2 0 0 0 2 2 0 0 2 2 2 0 0 2 2 0 0 0 2 2 0 0 2 2 2 0 0 2 2 0 0 0 2 2 0 0 2 2 0
0 2 0 0 2 2 2 0 0 0 2 2 2 0 0 2 0 0 2 2 2 0 0 0 2 2 2 0 0 2 0 0 2 2 2 0 0 0 2 2 2 0 0 2 0
0 2 0 0 0 2 2 0 0 0 2 2 0 0 0 2 0 0 0 2 2 0 0 0 2 2 0 0 0 2 0 0 0 2 2 0 0 0 2 2 0 0 0 2 0
0 2 2 0 0 0 2 0 0 0 2 0 0 0 2 2 2 0 0 0 2 0 0 0 2 0 0 0 2 2 2 0 0 0 2 0 0 0 2 0 0 0 2 2 0
0 0 2 2 0 0 2 2 2 2 2 0 0 2 2 0 2 2 0 0 2 2 2 2 2 0 0 2 2 0 2 2 0 0 2 2 2 2 2 0 0 2 2 0 0
0 0 0 2 2 0 0 2 2 2 0 0 2 2 0 0 0 2 2 0 0 2 2 2 0 0 2 2 0 0 0 2 2 0 0 2 2 2 0 0 2 2 0 0 0
0 0 0 0 2 2 0 0 2 0 0 2 2 0 0 0 0 0 2 2 0 0 2 0 0 2 2 0 0 0 0 0 2 2 0 0 2 0 0 2 2 0 0 0 0
0 0 0 0 0 2 2 0 2 0 2 2 0 0 0 0 0 0 0 2 2 0 2 0 2 2 0 0 0 0 0 0 0 2 2 0 2 0 2 2 0 0 0 0 0
0 0 0 0 0 0 2 2 2 2 2 0 0 0 0 0 0 0 0 0 2 2 2 2 2 0 0 0 0 0 0 0 0 0 2 2 2 2 2 0 0 0 0 0 0
0 0 0 0 0 0 2 2 2 2 2 0 0 0 0 0 0 0 0 0 2 2 2 2 2 0 0 0 0 0 0 0 0 0 2 2 2 2 2 0 0 0 0 0 0
0 0 0 0 0 2 2 0 2 0 2 2 0 0 0 0 0 0 0 2 2 0 2 0 2 2 0 0 0 0 0 0 0 2 2 0 2 0 2 2 0 0 0 0 0
0 0 0 0 2 2 0 0 2 0 0 2 2 0 0 0 0 0 2 2 0 0 2 0 0 2 2 0 0 0 0 0 2 2 0 0 2 0 0 2 2 0 0 0 0
0 0 0 2 2 0 0 2 2 2 0 0 2 2 0 0 0 2 2 0 0 2 2 2 0 0 2 2 0 0 0 2 2 0 0 2 2 2 0 0 2 2 0 0 0
0 0 2 2 0 0 2 2 2 2 2 0 0 2 2 0 2 2 0 0 2 2 2 2 2 0 0 2 2 0 2 2 0 0 2 2 2 2 2 0 0 2 2 0 0
0 2 2 0 0 2 2 0 0 0 2 2 0 0 2 2 2 0 0 2 2 0 0 0 2 2 0 0 2 2 2 0 0 2 2 0 0 0 2 2 0 0 2 2 0
0 2 0 0 2 2 2 0 0 0 2 2 2 0 0 2 0 0 2 2 2 0 0 0 2 2 2 0 0 2 0 0 2 2 2 0 0 0 2 2 2 0 0 2 0
0 2 0 0 0 2 2 0 0 0 2 2 0 0 0 2 0 0 0 2 2 0 0 0 2 2 0 0 0 2 0 0 0 2 2 0 0 0 2 2 0 0 0 2 0
0 2 2 0 0 0 2 0 0 0 2 0 0 0 2 2 2 0 0 0 2 0 0 0 2 0 0 0 2 2 2 0 0 0 2 0 0 0 2 0 0 0 2 2 0
0 0 2 2 0 0 2 2 2 2 2 0 0 2 2 0 2 2 0 0 2 2 2 2 2 0 0 2 2 0 2 2 0 0 2 2 2 2 2 0 0 2 2 0 0
0 0 0 2 2 0 0 2 3 2 0 0 2 2 0 0 0 2 2 0 0 2 2 2 0 0 2 2 0 0 0 2 2 0 0 2 2 2 0 0 2 2 0 0 0
0 0 0 0 2 2 0 0 2 0 0 2 2 0 0 0 0 0 2 2 0 0 2 0 0 2 2 0 0 0 0 0 2 2 0 0 2 0 0 2 2 0 0 0 0
0 0 0 0 0 2 2 0 2 0 2 2 0 0 0 0 0 0 0 2 2 0 2 0 2 2 0 0 0 0 0 0 0 2 2 0 2 0 2 2 0 0 0 0 0
0 0 0 0 0 0 2 2 2 2 2 0 0 0 0 0 0 0 0 0 2 2 2 2 2 0 0 0 0 0 0 0 0 0 2 2 2 2 2 0 0 0 0 0 0
0 0 0 0 0 0 0 0 0 0 0 0 0 0 0 0 0 0 0 0 0 0 0 0 0 0 0 0 0 0 0 0 0 0 0 0 0 0 0 0 0 0 0 0 0


Naive percentage explored at time checkpoints
[0.009541984732824428, 0.009541984732824428, 0.015267175572519083, 0.019083969465648856, 0.02099236641221374, 0.02099236641221374]

Naive percentage explored at rollout checkpoints
[0.009541984732824428, 0.01717557251908397, 0.022900763358778626, 0.030534351145038167, 0.04389312977099236, 0.05534351145038168]

