0 0 0 0 0 0 0 0 0 0 0 0 0 0 0 0 0 0 0 0 0 0 0 0 0 0 0 0 0 0 0 0 0 0 0 0 0 0 0 0 0 0 0 0 0
2 2 2 2 2 2 2 2 2 2 2 2 2 2 2 2 2 2 2 2 2 2 2 2 2 2 2 2 2 2 2 2 2 2 2 2 2 2 2 2 2 2 2 2 0
2 0 0 0 0 0 0 2 0 2 0 0 0 0 0 0 2 0 2 0 0 0 0 0 0 2 0 2 0 0 0 0 0 0 2 0 2 0 0 0 0 0 0 2 0
2 0 2 2 2 2 0 2 0 2 0 2 2 2 2 0 2 0 2 0 2 2 2 2 0 2 0 2 0 2 2 2 2 0 2 0 2 0 2 2 2 2 0 2 0
2 0 2 0 0 2 0 2 0 2 0 2 0 0 2 0 2 0 2 0 2 0 0 2 0 2 0 2 0 2 0 0 2 0 2 0 2 0 2 0 0 2 0 2 0
2 2 2 2 2 2 2 2 2 2 2 2 2 2 2 2 2 2 2 2 2 2 2 2 2 2 2 2 2 2 2 2 2 2 2 2 2 2 2 2 2 2 2 2 0
2 0 2 0 0 2 0 2 2 2 0 2 0 0 2 0 2 2 2 0 2 0 0 2 0 2 2 2 0 2 0 0 2 0 2 2 2 0 2 0 0 2 0 2 0
2 0 2 2 2 2 0 2 0 2 0 2 2 2 2 0 2 0 2 0 2 2 2 2 0 2 0 2 0 2 2 2 2 0 2 0 2 0 2 2 2 2 0 2 0
2 0 0 0 0 0 0 2 0 2 0 0 0 0 0 0 2 0 2 0 0 0 0 0 0 2 0 2 0 0 0 0 0 0 2 0 2 0 0 0 0 0 0 2 0
2 2 2 2 2 2 2 2 0 2 2 2 2 2 2 2 2 0 2 2 2 2 2 2 2 2 0 2 2 2 2 2 2 2 2 0 2 2 2 2 2 2 2 2 0
2 2 2 2 2 2 2 2 0 2 2 2 2 2 2 2 2 0 2 2 2 2 2 2 2 2 0 2 2 2 2 2 2 2 2 0 2 2 2 2 2 2 2 2 0
2 0 0 0 0 0 0 2 0 2 0 0 0 0 0 0 2 0 2 0 0 0 0 0 0 2 0 2 0 0 0 0 0 0 2 0 2 0 0 0 0 0 0 2 0
2 0 2 2 2 2 0 2 0 2 0 2 2 2 2 0 2 0 2 0 2 2 2 2 0 2 0 2 0 2 2 2 2 0 2 0 2 0 2 2 2 2 0 2 0
2 0 2 0 0 2 0 2 0 2 0 2 0 0 2 0 2 0 2 0 2 0 0 2 0 2 0 2 0 2 0 0 2 0 2 0 2 0 2 0 0 2 0 2 0
2 2 2 2 2 2 2 2 2 2 2 2 2 2 2 2 2 2 2 2 2 2 2 2 2 2 2 2 2 2 2 2 2 2 2 2 2 2 2 2 2 2 2 2 0
2 0 2 0 0 2 0 2 0 2 0 2 0 0 2 0 2 0 2 0 2 0 0 2 0 2 0 2 0 2 0 0 2 0 2 0 2 0 2 0 0 2 0 2 0
2 0 2 2 2 2 0 2 0 2 0 2 2 2 2 0 2 0 2 0 2 2 2 2 0 2 0 2 0 2 2 2 2 0 2 0 2 0 2 2 2 2 0 2 0
2 0 0 0 0 0 0 2 0 2 0 0 0 0 0 0 2 0 2 0 0 0 0 0 0 2 0 2 0 0 0 0 0 0 2 0 2 0 0 0 0 0 0 2 0
2 2 2 2 2 2 2 2 0 2 2 2 2 2 2 2 2 0 2 2 2 2 2 2 2 2 0 2 2 2 2 2 2 2 2 0 2 2 2 2 2 2 2 2 0
2 2 2 2 2 2 2 2 0 2 2 2 2 2 2 2 2 0 2 2 2 2 2 2 2 2 0 2 2 2 2 2 2 2 2 0 2 2 2 2 2 2 2 2 0
2 0 0 0 0 0 0 2 0 2 0 0 0 0 0 0 2 0 2 0 0 0 0 0 0 2 0 2 0 0 0 0 0 0 2 0 2 0 0 0 0 0 0 2 0
2 0 2 2 2 2 0 2 0 2 0 2 2 2 2 0 2 0 2 0 2 2 2 2 0 2 0 2 0 2 2 2 2 0 2 0 2 0 2 2 2 2 0 2 0
2 0 2 0 0 2 0 2 0 2 0 2 0 0 2 0 2 0 2 0 2 0 0 2 0 2 0 2 0 2 0 0 2 0 2 0 2 0 2 0 0 2 0 2 0
2 2 2 2 2 2 3 2 2 2 2 2 2 2 2 2 2 2 2 2 2 2 2 2 2 2 2 2 2 2 2 2 2 2 2 2 2 2 2 2 2 2 2 2 0
2 0 2 0 0 2 0 2 2 2 0 2 0 0 2 0 2 2 2 0 2 0 0 2 0 2 2 2 0 2 0 0 2 0 2 2 2 0 2 0 0 2 0 2 0
2 0 2 2 2 2 0 2 0 2 0 2 2 2 2 0 2 0 2 0 2 2 2 2 0 2 0 2 0 2 2 2 2 0 2 0 2 0 2 2 2 2 0 2 0
2 0 0 0 0 0 0 2 0 2 0 0 0 0 0 0 2 0 2 0 0 0 0 0 0 2 0 2 0 0 0 0 0 0 2 0 2 0 0 0 0 0 0 2 0
2 2 2 2 2 2 2 2 0 2 2 2 2 2 2 2 2 0 2 2 2 2 2 2 2 2 0 2 2 2 2 2 2 2 2 0 2 2 2 2 2 2 2 2 0
0 0 0 0 0 0 0 0 0 0 0 0 0 0 0 0 0 0 0 0 0 0 0 0 0 0 0 0 0 0 0 0 0 0 0 0 0 0 0 0 0 0 0 0 0
0 0 0 0 0 0 0 0 0 0 0 0 0 0 0 0 0 0 0 0 0 0 0 0 0 0 0 0 0 0 0 0 0 0 0 0 0 0 0 0 0 0 0 0 0


Naive percentage explored at time checkpoints
[0.0013440860215053765, 0.0013440860215053765, 0.002688172043010753, 0.002688172043010753, 0.004032258064516129, 0.006720430107526882, 0.006720430107526882, 0.006720430107526882, 0.006720430107526882, 0.006720430107526882, 0.009408602150537635]

Naive percentage explored at rollout checkpoints
[0.002688172043010753, 0.005376344086021506, 0.006720430107526882, 0.008064516129032258, 0.008064516129032258, 0.009408602150537635, 0.009408602150537635, 0.009408602150537635, 0.010752688172043012, 0.012096774193548387, 0.013440860215053764]

