0 0 0 0 0 0 0 0 0 0 0 0 0 0 0 0 0 0 0 0 0 0 0 0 0 0 0 0 0 0 0 0 0 0 0 0 0 0 0 0 0 0 0 0 0
0 2 2 2 2 2 2 2 2 2 2 2 2 2 2 2 2 2 2 2 2 2 2 2 2 2 2 2 2 2 2 2 2 2 2 2 2 2 2 2 2 2 2 2 0
0 0 0 0 0 2 0 0 0 0 0 0 0 2 0 0 0 0 0 0 0 0 2 0 0 0 0 0 0 0 0 2 0 0 0 0 0 0 0 2 0 0 0 0 0
0 2 2 2 2 2 2 2 2 2 2 2 2 2 2 2 2 2 2 2 2 2 2 2 2 2 2 2 2 2 2 2 2 2 2 2 2 2 2 2 2 2 2 2 0
0 2 0 0 0 2 0 0 0 2 0 0 0 2 0 0 0 2 2 0 0 0 2 0 0 0 2 2 0 0 0 2 0 0 0 2 0 0 0 2 0 0 0 2 0
0 2 0 0 2 2 2 0 0 2 0 0 2 2 2 0 0 2 2 0 0 2 2 2 0 0 2 2 0 0 2 2 2 0 0 2 0 0 2 2 2 0 0 2 0
0 2 0 0 0 0 0 0 0 2 0 0 0 0 0 0 0 2 2 0 0 0 0 0 0 0 2 2 0 0 0 0 0 0 0 2 0 0 0 0 0 0 0 2 0
0 2 2 2 2 2 2 2 2 2 2 2 2 2 2 2 2 2 2 2 2 2 2 2 2 2 2 2 2 2 2 2 2 2 2 2 2 2 2 2 2 2 2 2 0
0 2 2 2 2 2 2 2 2 2 2 2 2 2 2 2 2 2 2 2 2 2 2 2 2 2 2 2 2 2 2 2 2 2 2 2 2 2 2 2 2 2 2 2 0
0 0 0 0 0 2 0 0 0 0 0 0 0 2 0 0 0 0 0 0 0 0 2 0 0 0 0 0 0 0 0 2 0 0 0 0 0 0 0 2 0 0 0 0 0
0 2 2 2 2 2 2 2 2 2 2 2 2 2 2 2 2 2 2 2 2 2 2 2 2 2 2 2 2 2 2 2 2 2 2 2 2 2 2 2 2 2 2 2 0
0 2 0 0 0 2 0 0 0 2 0 0 0 2 0 0 0 2 2 0 0 0 2 0 0 0 2 2 0 0 0 2 0 0 0 2 0 0 0 2 0 0 0 2 0
0 2 0 0 2 2 2 0 0 2 0 0 2 2 2 0 0 2 2 0 0 2 2 2 0 0 2 2 0 0 2 2 2 0 0 2 0 0 2 2 2 0 0 2 0
0 2 0 0 0 0 0 0 0 2 0 0 0 0 0 0 0 2 2 0 0 0 0 0 0 0 2 2 0 0 0 0 0 0 0 2 0 0 0 0 0 0 0 2 0
0 2 2 2 2 2 2 2 2 2 2 2 2 2 2 2 2 2 2 2 2 2 2 2 2 2 2 2 2 2 2 2 2 2 2 2 2 2 2 2 2 2 2 2 0
0 2 2 2 2 2 2 2 2 2 2 2 2 2 2 2 2 2 2 2 2 2 2 2 2 2 2 2 2 2 2 2 2 2 2 2 2 2 2 2 2 2 2 2 0
0 0 0 0 0 2 0 0 0 0 0 0 0 2 0 0 0 0 0 0 0 0 2 0 0 0 0 0 0 0 0 2 0 0 0 0 0 0 0 2 0 0 0 0 0
0 2 2 2 2 2 2 2 2 2 2 2 2 2 2 2 2 2 2 2 2 2 2 2 2 2 2 2 2 2 2 2 2 2 2 2 2 2 2 2 2 2 2 2 0
0 2 0 0 0 2 0 0 0 2 0 0 0 2 0 0 0 2 2 0 0 0 2 0 0 0 2 2 0 0 0 2 0 0 0 2 0 0 0 2 0 0 0 2 0
0 2 0 0 2 2 2 0 0 2 0 0 2 2 2 0 0 2 2 0 0 2 2 2 0 0 2 2 0 0 2 2 2 0 0 2 0 0 2 2 2 0 0 2 0
0 2 0 0 0 0 0 0 0 2 0 0 0 0 0 0 0 2 2 0 0 0 0 0 0 0 2 2 0 0 0 0 0 0 0 2 0 0 0 0 0 0 0 2 0
0 2 2 2 2 2 2 2 2 2 2 2 2 2 2 2 2 2 2 2 2 2 2 2 2 2 2 2 2 2 2 2 2 2 2 2 2 2 2 2 2 2 2 2 0
0 2 2 2 2 2 2 2 2 2 2 2 2 2 2 2 2 2 2 2 2 2 2 2 2 2 2 2 2 2 2 2 2 2 2 2 2 2 2 2 2 2 2 2 0
0 0 0 0 0 2 0 0 0 0 0 0 0 2 0 0 0 0 0 0 0 0 2 0 0 0 0 0 0 0 0 2 0 0 0 0 0 0 0 2 0 0 0 0 0
0 2 2 2 2 3 2 2 2 2 2 2 2 2 2 2 2 2 2 2 2 2 2 2 2 2 2 2 2 2 2 2 2 2 2 2 2 2 2 2 2 2 2 2 0
0 2 0 0 0 2 0 0 0 2 0 0 0 2 0 0 0 2 2 0 0 0 2 0 0 0 2 2 0 0 0 2 0 0 0 2 0 0 0 2 0 0 0 2 0
0 2 0 0 2 2 2 0 0 2 0 0 2 2 2 0 0 2 2 0 0 2 2 2 0 0 2 2 0 0 2 2 2 0 0 2 0 0 2 2 2 0 0 2 0
0 2 0 0 0 0 0 0 0 2 0 0 0 0 0 0 0 2 2 0 0 0 0 0 0 0 2 2 0 0 0 0 0 0 0 2 0 0 0 0 0 0 0 2 0
0 2 2 2 2 2 2 2 2 2 2 2 2 2 2 2 2 2 2 2 2 2 2 2 2 2 2 2 2 2 2 2 2 2 2 2 2 2 2 2 2 2 2 2 0
0 0 0 0 0 0 0 0 0 0 0 0 0 0 0 0 0 0 0 0 0 0 0 0 0 0 0 0 0 0 0 0 0 0 0 0 0 0 0 0 0 0 0 0 0


Naive percentage explored at time checkpoints
[0.0014044943820224719, 0.0028089887640449437, 0.004213483146067416, 0.0056179775280898875, 0.0056179775280898875, 0.007022471910112359, 0.008426966292134831, 0.011235955056179775, 0.011235955056179775, 0.011235955056179775, 0.011235955056179775]

Naive percentage explored at rollout checkpoints
[0.0014044943820224719, 0.0028089887640449437, 0.0028089887640449437, 0.0028089887640449437, 0.0028089887640449437, 0.0028089887640449437, 0.0028089887640449437, 0.0028089887640449437, 0.004213483146067416, 0.0056179775280898875, 0.008426966292134831]

