0 0 0 0 0 0 0 0 0 0 0 0 0 0 0 0 0 0 0 0 0 0 0 0 0 0 0 0 0 0 0 0 0 0 0 0 0 0 0 0 0 0 0 0 0
0 0 0 0 0 0 0 0 0 0 0 0 0 0 0 0 0 0 0 0 0 0 0 0 0 0 0 0 0 0 0 0 0 0 0 0 0 0 0 0 0 0 0 0 0
2 2 2 2 2 2 2 2 0 2 2 2 2 2 2 2 2 0 2 2 2 2 2 2 2 2 0 2 2 2 2 2 2 2 2 0 2 2 2 2 2 2 2 2 0
2 0 2 0 0 0 0 2 0 2 0 2 0 0 0 0 2 0 2 0 2 0 0 0 0 2 0 2 0 2 0 0 0 0 2 0 2 0 2 0 0 0 0 2 0
2 0 2 2 2 2 0 2 0 2 0 2 2 2 2 0 2 0 2 0 2 2 2 2 0 2 0 2 0 2 2 2 2 0 2 0 2 0 2 2 2 2 0 2 0
2 0 2 0 0 2 0 2 0 2 0 2 0 0 2 0 2 0 2 0 2 0 0 2 0 2 0 2 0 2 0 0 2 0 2 0 2 0 2 0 0 2 0 2 0
2 0 2 0 0 2 0 2 0 2 0 2 0 0 2 0 2 0 2 0 2 0 0 2 0 2 0 2 0 2 0 0 2 0 2 0 2 0 2 0 0 2 0 2 0
2 0 2 0 0 2 0 2 0 2 0 2 0 0 2 0 2 0 2 0 2 0 0 2 0 2 0 2 0 2 0 0 2 0 2 0 2 0 2 0 0 2 0 2 0
2 0 2 2 2 2 0 2 0 2 0 2 2 2 2 0 2 0 2 0 2 2 2 2 0 2 0 2 0 2 2 2 2 0 2 0 2 0 2 2 2 2 0 2 0
2 0 2 0 0 0 0 2 0 2 0 2 0 0 0 0 2 0 2 0 2 0 0 0 0 2 0 2 0 2 0 0 0 0 2 0 2 0 2 0 0 0 0 2 0
2 2 2 2 2 2 2 2 0 2 2 2 2 2 2 2 2 0 2 2 2 2 2 2 2 2 0 2 2 2 2 2 2 2 2 0 2 2 2 2 2 2 2 2 0
2 2 2 2 2 2 2 2 0 2 2 2 2 2 2 2 2 0 2 2 2 2 2 2 2 2 0 2 2 2 2 2 2 2 2 0 2 2 2 2 2 2 2 2 0
0 0 0 0 0 0 0 2 0 0 0 0 0 0 0 0 2 0 0 0 0 0 0 0 0 2 0 0 0 0 0 0 0 0 2 0 0 0 0 0 0 0 0 2 0
0 0 0 0 0 0 0 2 0 0 0 0 0 0 0 0 2 0 0 0 0 0 0 0 0 2 0 0 0 0 0 0 0 0 2 0 0 0 0 0 0 0 0 2 0
0 0 0 0 0 0 0 2 0 0 0 0 0 0 0 0 2 0 0 0 0 0 0 0 0 2 0 0 0 0 0 0 0 0 2 0 0 0 0 0 0 0 0 2 0
2 2 2 2 2 2 2 2 2 2 2 2 2 2 2 2 2 2 2 2 2 2 2 2 2 2 2 2 2 2 2 2 2 2 2 2 2 2 2 2 2 2 2 2 2
0 0 0 0 0 0 0 2 0 0 0 0 0 0 0 0 2 0 0 0 0 0 0 0 0 2 0 0 0 0 0 0 0 0 2 0 0 0 0 0 0 0 0 2 0
0 0 0 0 0 0 0 2 0 0 0 0 0 0 0 0 2 0 0 0 0 0 0 0 0 2 0 0 0 0 0 0 0 0 2 0 0 0 0 0 0 0 0 2 0
2 2 2 2 2 2 2 2 0 2 2 2 2 2 2 2 2 0 2 2 2 2 2 2 2 2 0 2 2 2 2 2 2 2 2 0 2 2 2 2 2 2 2 2 0
2 2 2 2 2 2 2 2 0 2 2 2 2 2 2 2 2 0 2 2 2 2 2 2 2 2 0 2 2 2 2 2 2 2 2 0 2 2 2 2 2 2 2 2 0
2 0 2 0 0 0 0 2 0 2 0 2 0 0 0 0 2 0 2 0 2 0 0 0 0 2 0 2 0 2 0 0 0 0 2 0 2 0 2 0 0 0 0 2 0
2 0 2 2 2 2 0 2 0 2 0 2 2 2 2 0 2 0 2 0 2 2 2 2 0 2 0 2 0 2 2 2 2 0 2 0 2 0 2 2 2 2 0 2 0
2 0 2 0 0 2 0 2 0 2 0 2 0 0 2 0 2 0 2 0 2 0 0 2 0 2 0 2 0 2 0 0 2 0 2 0 2 0 2 0 0 2 0 2 0
2 0 2 0 0 2 0 2 0 2 0 2 0 0 2 0 2 0 2 0 2 0 0 2 0 2 0 2 0 2 0 0 2 0 2 0 2 0 2 0 0 2 0 2 0
2 0 2 0 0 3 0 2 0 2 0 2 0 0 2 0 2 0 2 0 2 0 0 2 0 2 0 2 0 2 0 0 2 0 2 0 2 0 2 0 0 2 0 2 0
2 0 2 2 2 2 0 2 0 2 0 2 2 2 2 0 2 0 2 0 2 2 2 2 0 2 0 2 0 2 2 2 2 0 2 0 2 0 2 2 2 2 0 2 0
2 0 2 0 0 0 0 2 0 2 0 2 0 0 0 0 2 0 2 0 2 0 0 0 0 2 0 2 0 2 0 0 0 0 2 0 2 0 2 0 0 0 0 2 0
2 2 2 2 2 2 2 2 0 2 2 2 2 2 2 2 2 0 2 2 2 2 2 2 2 2 0 2 2 2 2 2 2 2 2 0 2 2 2 2 2 2 2 2 0
0 0 0 0 0 0 0 0 0 0 0 0 0 0 0 0 0 0 0 0 0 0 0 0 0 0 0 0 0 0 0 0 0 0 0 0 0 0 0 0 0 0 0 0 0
0 0 0 0 0 0 0 0 0 0 0 0 0 0 0 0 0 0 0 0 0 0 0 0 0 0 0 0 0 0 0 0 0 0 0 0 0 0 0 0 0 0 0 0 0


Naive percentage explored at time checkpoints
[0.003278688524590164, 0.004918032786885246, 0.004918032786885246, 0.006557377049180328, 0.006557377049180328, 0.006557377049180328, 0.006557377049180328, 0.019672131147540985, 0.021311475409836064, 0.022950819672131147, 0.03114754098360656]

Naive percentage explored at rollout checkpoints
[0.003278688524590164, 0.003278688524590164, 0.004918032786885246, 0.006557377049180328, 0.00819672131147541, 0.00819672131147541, 0.00819672131147541, 0.00819672131147541, 0.00819672131147541, 0.00819672131147541, 0.013114754098360656]

